1111111
100P001
10C0001
1111111